1543-1543-1543-1543-1543-1543-1543-1543-1543-1543-1543-1543-1543-1543-1543-1543-1543-1543-1543-1543
1543-0000-0000-0000-0513-0000-0513-0000-0000-0000-0000-0000-0000-0000-0000-0000-0000-0000-0000-1543
1543-0000-0000-0000-0000-0000-0000-0000-0513-0513-0513-0000-0513-0513-0513-0513-0513-0513-0000-1543
1543-0000-0000-0000-0513-0000-0513-0000-0513-0000-0513-0000-0000-0000-0000-0000-0000-0513-0000-1543
1543-0513-0513-0513-0513-0513-0513-0000-0513-0000-0513-0513-0513-0000-0513-0513-0513-0513-0000-1543
1543-0000-0000-0000-0513-0000-0000-0000-0513-0000-0000-0000-0513-0000-0513-0000-0000-0000-0000-1543
1543-0513-0513-0000-0513-0000-0513-0000-0513-0513-0513-0000-0513-0000-0513-0000-0513-0513-0000-1543
1543-0000-0000-0000-0513-0000-0513-0000-0000-0000-0000-0000-0513-0000-0000-0000-0513-0000-0000-1543
1543-0000-0513-0513-0513-0513-0513-0000-0513-0513-0513-0000-0513-0513-0513-0000-0513-0513-0000-1543
1543-0000-0513-0000-0000-0000-0000-0000-0513-0000-0000-0000-0513-0000-0000-0000-0000-0000-0000-1543
1543-0000-0513-0000-0513-0513-0513-0000-0513-0513-0513-0513-0513-0000-0513-0513-0513-0513-0513-1543
1543-0000-0000-0000-0513-0000-0000-0000-0513-0000-0000-0000-0000-0000-0513-0000-0000-0000-0513-1543
1543-0000-0513-0513-0513-0000-0513-0513-0513-0000-0513-0000-0513-0000-0513-0000-0513-0000-0000-1543
1543-0000-0000-0000-0000-0000-0513-0000-0000-0000-0513-0000-0513-0000-0000-0000-0513-0000-0000-1543
1543-0513-0513-0000-0513-0000-0513-0513-0513-0513-0513-0000-0513-0513-0513-0000-0513-0513-0000-1543
1543-0000-0000-0000-0513-0000-0000-0000-0000-0000-0513-0000-0000-0000-0000-0000-0000-0000-0000-1543
1543-0000-0513-0000-0513-0513-0513-0513-0513-0000-0513-0513-0513-0513-0000-0513-0513-0000-0513-1543
1543-0000-0513-0000-0000-0000-0000-0000-0513-0000-0000-0000-0000-0000-0000-0000-0513-0000-0000-1543
1543-0000-0000-0000-0513-0000-0513-0000-0513-0000-0513-0513-0513-0000-0513-0000-0513-0000-9251-1543
1543-1543-1543-1543-1543-1543-1543-1543-1543-1543-1543-1543-1543-1543-1543-1543-1543-1543-1543-1543