8737-8737-8737-8737-8737-8737-8737-8737-8737-8737-8737-8737-8737-8737-8737-8737-8737-8737-8737-8737
8737-0000-0000-0000-0513-0000-0513-0000-0000-0000-0000-0000-0000-0000-0000-0000-0000-0000-0000-8737
8737-0000-0000-0000-0000-0000-0000-0000-0513-0513-0513-0000-0513-0513-0513-0513-0513-0513-0000-8737
8737-0000-0000-0000-0513-0000-0513-0000-0513-0000-0513-0000-0000-0000-0000-0000-0000-0513-0000-8737
8737-0513-0513-0513-0513-0513-0513-0000-0513-0000-0513-0513-0513-0000-0513-0513-0513-0513-0000-8737
8737-0000-0000-0000-0513-0000-0000-0000-0513-0000-0000-0000-0513-0000-0513-0000-0000-0000-0000-8737
8737-0513-0513-0000-0513-0000-0513-0000-0513-0513-0513-0000-0513-0000-0513-0000-0513-0513-0000-8737
8737-0000-0000-0000-0513-0000-0513-0000-0000-0000-0000-0000-0513-0000-0000-0000-0513-0000-0000-8737
8737-0000-0513-0513-0513-0513-0513-0000-0513-0513-0513-0000-0513-0513-0513-0000-0513-0513-0000-8737
8737-0000-0513-0000-0000-0000-0000-0000-0513-0000-0000-0000-0513-0000-0000-0000-0000-0000-0000-8737
8737-0000-0513-0000-0513-0513-0513-0000-0513-0513-0513-0513-0513-0000-0513-0513-0513-0513-0513-8737
8737-0000-0000-0000-0513-0000-0000-0000-0513-0000-0000-0000-0000-0000-0513-0000-0000-0000-0513-8737
8737-0000-0513-0513-0513-0000-0513-0513-0513-0000-0513-0000-0513-0000-0513-0000-0513-0000-0000-8737
8737-0000-0000-0000-0000-0000-0513-0000-0000-0000-0513-0000-0513-0000-0000-0000-0513-0000-0000-8737
8737-0513-0513-0000-0513-0000-0513-0513-0513-0513-0513-0000-0513-0513-0513-0000-0513-0513-0000-8737
8737-0000-0000-0000-0513-0000-0000-0000-0000-0000-0513-0000-0000-0000-0000-0000-0000-0000-0000-8737
8737-0000-0513-0000-0513-0513-0513-0513-0513-0000-0513-0513-0513-0513-0000-0513-0513-0000-0513-8737
8737-0000-0513-0000-0000-0000-0000-0000-0513-0000-0000-0000-0000-0000-0000-0000-0513-0000-0000-8737
8737-0000-0000-0000-0513-0000-0513-0000-0513-0000-0513-0513-0513-0000-0513-0000-0513-0000-9251-8737
8737-8737-8737-8737-8737-8737-8737-8737-8737-8737-8737-8737-8737-8737-8737-8737-8737-8737-8737-8737